stol	[rodmorfem](substantiv)
lille	[rodmorfem](adjektiv)
op	[rodmorfem](præposition)
barn	[rodmorfem](substantiv)
menneske	[rodmorfem](substantiv)
fugl	[rodmorfem](substantiv)
stor	[rodmorfem](adjektiv)
gammel	[rodmorfem](adjektiv)
spids	[rodmorfem](substantiv)/(adjektiv)
hård	[rodmorfem](adjektiv)
gom	[rodmorfem](substantiv)
måned	[rodmorfem](substantiv)
bryn	[rodmorfem](substantiv)
snot	[rodmorfem](substantiv)
skole	[rodmorfem](substantiv)
port	[rodmorfem](substantiv)
idol	[rodmorfem](substantiv)
kammerat	[rodmorfem](substantiv)
lev	[rodmorfem](verbum)
sigt	[rodmorfem](verbum)
sigte	[rodmorfem](substantiv)
tyd	[rodmorfem](verbum)
spring	[rodmorfem](substantiv)/(verbum)
sælg	[rodmorfem](verbum)
skovsnegl	skov-snegl (substantiv) skov [rodmorfem](substantiv) snegl [rodmorfem](substantiv)
husgavl	hus-gavl (substantiv) hus [rodmorfem](substantiv) gavl [rodmorfem](substantiv)
fradrag	fra-drag (verbum/substantiv) fra[rodmorfem](adverbium) drag[rodmorfem](verbum)
fadøl	fad-øl (substantiv) fad [rodmorfem](substantiv) øl [rodmorfem](substantiv)
farfar	far-far (substantiv) far[rodmorfem](substantiv) far[rodmorfem](substantiv)
skadestue	skade-stue (substantiv) skade[rodmorfem](substantiv) stue[rodmorfem](substantiv)
håndværk	hånd-værk (substantiv) hånd[rodmorfem](substantiv) værk[rodmorfem](substantiv)
blodtryk	blod-tryk (substantiv) blod[rodmorfem](substantiv) tryk[rodmorfem](substantiv)
plantevækst	plante-vækst (substantiv) plante[rodmorfem](substantiv) vækst[rodmorfem](substantiv)
efterår	efter-år (substantiv) efter[rodmorfem](adverbium) år[rodmorfem](substantiv)
filterkaffe	filter-kaffe (substantiv) filter[rodmorfem](substantiv) kaffe[rodmorfem](substantiv)
autostol	auto-stol (substantiv) auto[rodmorfem](substantiv) stol[rodmorfem](substantiv)
nervebane	nerve-bane (substantiv) nerve[rodmorfem](substantiv) bane[rodmorfem](substantiv)
nervesystem	nerve-system (substantiv) nerve[rodmorfem](substantiv) system[rodmorfem](substantiv)
rygmarv	ryg-marv (substantiv) ryg[rodmorfem](substantiv) marv[rodmorfem](substantiv)
pulsåre	puls-åre (substantiv) puls[rodmorfem](substantiv) åre[rodmorfem](substantiv)
tyndtarm	tynd-tarm (substantiv) tynd[rodmorfem](adjektiv) tarm[rodmorfem](substantiv)
urinblære	urin-blære (substantiv) urin[rodmorfem](substantiv) blære[rodmorfem](substantiv)
livmoder	liv-moder (substantiv) liv[rodmorfem](substantiv) moder[rodmorfem](substantiv)
fritid	fritid (substantiv) fri[rodmorfem](adjektiv) tid[rodmorfem](substantiv)
vildhund	vild-hund (substantiv) vild[rodmorfem](adjektiv) hund[rodmorfem](substantiv)
flodhest	flod-hest (substantiv) flod[rodmorfem](substantiv) hest[rodmorfem](substantiv)
plejehjem	plej-e-hjem (substantiv) plej[rodmorfem][verbum] e[klistermorfem] hjem[rodmorfem](substantiv)
verdenskrig	verden-s-krig (substantiv) verden[rodmorfem](substantiv) s[klistermorfem] krig[rodmorfem](substantiv)
landstræner	land-s-træn-er (substantiv) land[rodmorfem](substantiv) s[klistermorfem] træn[rodmorfem](verbum) er[suffiks]
skrivelyst	skriv-e-lyst (substantiv) skriv[rodmorfem](adjektiv) e[klistermorfem] lyst[rodmorfem](substantiv)
løbesko	løb-e-sko (substantiv) løb[rodmorfem](verbum) e[klistermorfem] sko[rodmorfem](substantiv)
synspunkt	syn-s-punkt (substantiv)syn[rodmorfem](substantiv) s[klistermorfem] punkt[rodmorfem](substantiv)
mistænk	mis-tænk (verbum) mis[præfiks] tænk[rodmorfem](verbum) 
import	im-port (substantiv) im[præfiks] port[rodmorfem](verbum)
bibringe	bi-bringe (verbum) bi[præfiks] bringe[rodmorfem](verbum)
benyt	be-nyt (verbum) be[præfiks] nyt[rodmorfem](verbum)	
ugift	u-gift (adjektiv) u[præfiks] gift[rodmorfem](adjektiv)
bebuder	be-bud-er (substantiv) be[præfiks] bud[rodmorfem](verbum) er[suffiks]
bedøm	be-døm (verbum) be[præfiks] døm[rodmorfem](verbum)
ekskone	eks-kone (substantiv) eks[præfiks] kone[rodmorfem](substantiv)
venlig	ven-lig [adjektiv] ven[rodmorfem](substantiv) lig[suffiks]
årlig	år-lig (adjektiv) år[rodmorfem](substantiv) lig[suffiks]
tænkning	tænk-ning (substantiv) tænk[rodmorfem](verbum) ning[suffiks]
trivsel	triv-sel (substantiv) triv[rodmorfem](verbum) sel[suffiks]
retning	ret-ning (substantiv) ret[rodmorfem](verbum) ning[suffiks]
rødeste	rød-e-ste (adjektiv) rød[rodmorfem](adjektiv) e[fleksiv](adjektiv/pluralis) ste[fleksiv](adjektiv/superlativ)
brillerne	brille-r-ne (substantiv) hus[rodmorfem](substantiv) r[fleksiv](substantiv, pluralis,indefinitus) ne[fleksiv](substantiv, pluralis, definitus) 
højere	høj-ere (adjektiv) høj[rodmorfem](adjektiv) ere[fleksiv](adjektiv/komparativ)
venligere	ven-lig-ere (adjektiv) ven[rodmorfem](substantiv) lig [suffiks] ere[fleksiv](adjektiv/komparativ)
spiste	spis-te (verbum)	spis[rodmorfem](verbum) te[fleksiv](verbum,imperfektum)
lånte	lån-te (verbum)	lån[rodmorfem](verbum) te[fleksiv](verbum,imperfektum)
kendte	kend-te (verbum) kend[rodmorfem](verbum) te[fleksiv](verbum,imperfektum)